10 1 4
XXX XXXXXX
XXX XXXXXX
XX    XXXX
X  XXXXXXX
X XXXXXXXX
X   XXXXXX
X X     XX
  XXXX XXX
X XXXX XXX
X XXXX XXX